111111111111111
100000000000001
100P0000000E001
100000000000001
100000000000001
100C00000000001
10000000000E001
111111111111111