1111111111111
10000000000P1
1E00000000001
1000000000001
1000000000001
1111111111111