1111111111111
1000000000001
100000C000001
1000E00000001
100C00P000001
1000000000001
1111111111111