111111111
1000C01P1
100000111
10000C001
1000E0001
100000001
111111111