111111111
1000C0001
100000001
10000C001
1000E0001
111111111